11111111111111111111
1000001000C0C0100001
100001C0000000C10001
100001110000011100P1
10000000000000000011
1000011100E001110001
100000C1000001C00001
10000010000CC0100001
11111111111111111111