11111111111111111111
1000001000C0C0100001
100001C0000000C10011
10000111010101110001
100P0000010100000011
1322011101E101110001
132200C1010131C00001
132200100131C0000001
11111111111111111111