11111111111111111111
1000001000C0C0100001
100001C0000000C10011
10000111000001110001
100P0000000000000011
1322011101E101110001
132200C1000331C00001
132200100033C0000001
11111111111111111111