1111111111111111
1000000001C00001
1E00001000000001
100000000P000001
1111111111111111