11111111111111111111
1000001000C0C0100001
100001C0000000C10011
100001110000011100P1
1000000000100000C011
1322011101E101110001
132200C1000031C00001
132200100003C0000001
11111111111111111111