11111111111111111111111111111111111111111111111111
11010010100110100000C00111001011011000110000111011
10100100E00101101000001010100100000000111110010001
100001111100000000011110011110001010110000P0001011
11010110001110100000001010110100011000001000100011
10001100000000001000001000000000010100110100001011
111111C0000010001000000011001011011101001010011011
10001010011000000111000010001010000C01010010010011
10001001011010010100122200001000001101100111010101
11000001010100100111111101100000101101000110001001
10000000000010001000000101001100011010010110000101
11110001101000001010000001011010100101100001000101
1001001110001011000110000101101C011011100110001101
100100100110010000C1000110110000010110010100011001
10010100011000010100000001101000111001100100000101
10001000011100000011000011001101001001000000010001
10101000100111010001000000011010100000000101000001
11000100010100000000000010010101000001010000101001
10100001000010011010000110001000101000110011000001
11001011101001100000000100000010100100100000100001
11010001110001000000C11100001001001001001000101111
10000010000110100010111100000000000001111000100011
11001110100001100001010010100000010000010000001111
10010001000010000010000001011001000000000100100101
10000000100011010000000010111001010101000000011101
11000111010000000110010100110000100000101001100101
10011011010101001010011000111000010000000010011001
10010010100000000001000010101000100011001011110001
10010000000101000011010011001010000010001000000001
10100111000010001001000100000101001110100010010001
1C000100001000001100010000110101100101010010011001
10001011001101101010000000001000100111000010111001
1001010000110001010C000110000010100001001011010011
10010001001001010001110100010111001001001100011101
11001111011110000011000100010010100100011110110101
11011010001010000001001011001000100101001000001101
10000100000010111000111010100011000101000100101011
111010100100001C0101001100110000010000100100010011
10100000000001001100101C00100110110100011010100011
101110111010000000001110011011010C1010000000001011
11100011010010101000000000001000000100001001110001
1001000000110110000111100010110C010010010110000011
10100010110001000C00110011101010001001000001110101
10011000000001001000001000000101100110101100011011
11110000101100111111100000010111100000001000000001
1101110110001101000000010001001100011010100000C111
10000111100000101001000101101000000100000001010111
10101010011100110100101000001110000111000010000011
10100100000000101000001011100000011010100000110001
11111111111111111111111111111111111111111111111111