11111111111111111111111
10001111110E000000000P1
10001CCCC1000000CCCC001
11111111111111111111111