11111111111111111111
11111111111111111011
11110000C00000000001
10000000000000000001
1000P00000000000E001
11111111111111111111