111111111111111111111111111111111111111111111111111111111111111111111111111111111111111111111111111111111111111111111111111111111111111111111111111111111111
1CCCCCCCCC00000000000000000000000000000000000000000000000000000000000000000000000000000000000000000000000223333333333333333333333333333333333333333333333331
1CCCCCCCCCCCC0000000000000000000000000000000000000000000000000000000000000000000000000000000000000P000000002222233333333333333333333333333333333333333333331
1CCCCCCCCCCC000000000000000000000000000000000000000000000000000000000000000000000000000000000000000000000000000222222222222222222222222222222222222222222221
1CCCCCCCCCCCCCC000000000000000000000000000000000000002333300000000000000000000000000000000000000000000000000000000000000000000000000000000000000000000000001
1CCCCCCCCCC0000000000000000000000000000000000000000002333330000000000000000000000000000000000000000000000000000000000000000000000000000000000000000000000001
1CCCCCC00000000000000000000000000000000000000000000002333333000000000000000000000000000000000000000000000000000000000000000000000000000000000000000000000001
100000000000000000000000000000000000000000000000000002233333300000000000000000000000000000000000000000000000000000000000000000000000000000000000000000000001
100000000000000000000000000000000000000000000000000000222333330000000000000000000000000000000000000000000000000000000000000000000000000000000000000000000001
100000000000000000000000000000000000000000000000000000002222333300000000000000000000000000000000000000000000000000000000000000000000000000000000000000000001
100000000000000000000000000000000000000000000000000000002333333000000000000000000000000000000000000000000000000000000000000000000000000000000000000000000001
100000000000000000000000000000000000000000000000000000002222333333000000000000000000000000000000000000000000000000000000000000000000000000000000000000000001
100000000000000000000000000000000000000000000000000000000002222333333333333000000000000000000000000000000000000000000000000000000000000000000000000000000001
100000000000000000000000000000000000000000000000000000000000003333333333333330000000000000000000000000000000000000000000000000000000000000000000000000000001
100000000000000000000000000000011111110000000000000000000000033333333333333333000000000000000000000000000000000000000000000000000000000000000000000000000001
100000000000000000000000000000000111110000000000000000000000003333333333333333000000000000000000000000000000000000000000000000000000000000000000000000000001
100000000000000000000000000000001111110000000000000000000000033333333333333330000000000000000000000000000000000000000000000000000000000000000000000000000001
100000000000000011111111111111111111110000000000000000000000003333333333333300000000000000000000000000000000000000000000000000000000000000000000000000000001
100000000000000001111111111111111111110000000000000000000000002222333333333000000000000000000000000000000000000000000000000000000000000000000000000000000001
100000000000000000011111111111111111111111100000000000000000000023333333300000000000000000000000000000000000000000000000000000000000000000000000000000000001
100000000111111111111111111111111111111111111000000000000000203333333000000000000000000000111111111111111110000000000000000000000000000000000000000000000001
100001111111111111111111111111111111111111111111000000000000222233333333300000000000000011111111111111111111000000000000000000000000000000000000000000000001
100001111111111111111111111111111111111111111110000000000000000000000333333300000000000011111111111111111111100000000000000000000000000000000000000000000001
100000000001111111111111111111111111111111111000000000000000000000000003333330000000000111111111111111111111110000000000000000000000000000000000000000000001
100000000111111111111111111111111111000000000000000000000000000000000033333330000000011111111111111111111111111000000000000000000000000000000000000000000001
100000000000000011111111111111111111111000000000000000000000000000000003333330000000000000111111111111111111111111000000000000000000000000000000000000000001
100000000000000000000011111111111111000000000000000000000000000000000000033333000000000000001111111111111111111111110000000000000000000000000000000000000001
100000000000111111111111111000000000000000000000000000000000000000000000003333330000000000000011111111111111111111111000000000000000000000000000000000000001
100000000000000000000000000000000000000000000000000000000000000000000000000033333333000000000000000011111111111110000000000000000000000000000000000000000001
100000000000000000000000000000000000000000000000000000000000000000000000000000000000000000000000000000000000000000000000000000000000000000000000000000000001
100000000000000000000000000000000000000000000000000000000000000000000000000000000000000000000000000000000000000000000000000000000000000000000000000000000001
100000000000000000000000000000000000000000000000000000000000000000000000000000000000000000000000000000000000000000000000000000000000000000000000000000000001
100000000000000000000000000000000000000000000000000000000000000000000000000000000000000000000000000000000000000000000000000000000000000000000000000000000001
100000000000000000000000000000000000000000000000000000000000000000000000000000000000000000000000000000000000000000000000000000000000000000000000000000000001
100000000000000000000000000000000000000000000000000000000000000000000000000000000000000000000000000000000000000000000000000000000000000000000000000000000001
1000000000000000000000000000000000000000000000000000000000000000000000000000000000000000000000000000000000000000CCCCCCCCCCCCCCCCCCCCCCCCCCCC0000000000000001
100000000000000000000000000000000000000000000000000000000000000000000000000000000000000000000000000000000000000CCCCCCCCCCCCCCCCCCCCCCCCCCCCCCCC0000000000001
10000000000000000000000000000000000000000000000000000000000000000000000000000000000000000000000000000000000CCCCCCCCCCCCCCCCCCCCCCCCCCCCCCCCCCCCCC00000000001
100000000000000000000000000000000000000000000000000000000000000000000000000000000000000000000000000000000000CCCCCCCCCCCCCCCCCCCCCCCCCCCCCCCCCCCCCC0000000001
100000000000E00000000000000000000000000000000000000000000000000000000000000000000000000000000000000000000000000CCCCCCCCCCCCCCCCCCCCCCCCCCCCCCCCCC00000000001
100000000000000000000000000000000000000000000000000000000000000000000000000000000000000000000000000000000000000000CCCCCCCCCCCCCCCCCCCCCCCC000000000000000001
100000000000000000000000000000000000000000000000000000000000000000000000000000000000000000000000000000000000000000000000000000000000000000000000000000000001
100000000000000000000000000000000000000000000000000000000000000000000000000000000000000000000000000000000000000000000000000000000000000000000000000000000001
100000000000000000000000000000000000000000000000000000000000000000000000000000000000000000000000000000000000000000000000000000000000000000000000000000000001
100000000000000000000000000000000000000000000000000000000000000000000000000000000000000000000000000000000000000000000000000000000000000000000000000000000001
111111111111111111111111111111111111111111111111111111111111111111111111111111111111111111111111111111111111111111111111111111111111111111111111111111111111